ssssssssss
s        s
s s      s
s s      s
s w w w  s
s w      s
s        s
s        s
s        s
ssssssssss
